///////////////////////////////////////////////////
// *origin:	O		*marker:	o
// *start:	S		*goal:		G
// *dealer:	D d		*trap:		!
// *fuel:	+ 🌢		*gold:		$
// *clock:	C c		*bit:		B b
// *flag:	F f		*oracle		?
// *info:	i
// *portal:	& @ % * = ~ § £ ¤
// *comment:	line starting with /
// *wall:	any other character but space
///////////////////////////////////////////////////
// The World //////////////////////////////////////
///////////////////////////////////////////////////
###################################################
#   #         #      #                            #
# % #   #     #   #  #  #######   #############   #
#   #   #     #   #  #  #     #   #     S     #   #
#   #   #     #   #  #  #  #  #   #           #   #
#   #   #         #     #  #  #   #     +     #   #
#   #   #################  #  #   #S   +++   S#   #
#   #                      #  #   #     +     #   #
#   #####################  #  #   #           #   #
#   #                      #  #   #     S         #
#   #    ###################  #   #############   #
#   #    #                    #                   #
#   # ++ #   ##################################   #
#   #    #                                  % #   #
#   #    ######################################   #
#   #           # @         #               @ #   #
# + ########    ##########  #  ################   #
#                           #                     #
############################################### + #
#   $                                             #
# + ###############################################
#   # +             @ # %                         #
#   # + ####################################### + #
#   # +               #                           #
#   ################  #  ###################### + #
#   #                 #                       #   #
#   #   ##################################    #   #
#   #                                    #    #   #
#   #################  ###############   # ++ #   #
#                   #  # %               #    #   #
#   #############   #  ###################    #   #
#   #     S     #   #  #                      #   #
#   #           #   #  #  #####################   #
#   #     +     #   #  #                      #   #
#   #S   +++   S#   #  ###################    #   #
#   #     +     #   #  #        #        #    #   #
#   #           #   #  #    #   #   #    #    #   #
#   #     S         #       #   #   #    #    #   #
#   #############   #########   #   #    #    # @ #
#                                   #         #   #
###################################################
