###########################
#        #        #########
#        #                #
#        #                #
#        #                #
#        #                #
#        #                #
#        #                #
#        #        #########
#        #        #########
#   S             #########
#        #        #########
#        #        #########
#        #        #########
###########################
