#####
#   #
# S #
#   #
#####
