/////////////////////////////////////////////////////////////////////////////////////////////////////
// *origin:	O		*marker:	o		*flag:		F f
// *start:	S		*goal:		G		*oracle:	?
// *dealer:	D d		*trap:		!		*info		i
// *fuel:	+ 🌢		*gold:		$		*portal:	& @ % * ~ § £ ¤
// *clock:	C c		*bit:		B b		*comment:	line starting with /
// *wall:	any other character but space
/////////////////////////////////////////////////////////////////////////////////////////////////////
#####################################################################################################
#                                                                                                   #
#  S                                              +                                              S  #
#                                                                                                   #
#                                                                                                   #
#            ! ####################################################################### !            #
#                                                                                                   #
#        !                                                                                 !        #
#        #                                                                                 #        #
#        #         #   # ##### #     #     #####     #   # ##### ####  #     ####          #        #
#        #         #   # #     #     #     #   #     #   # #   # #   # #     #   #         #        #
#  +     # ?       ##### ###   #     #     #   #  G  # # # #   # ####  #     #   #       ? #     +  #
#        #         #   # #     #     #     #   #     # # # #   # #  #  #     #   #         #        #
#        #         #   # ##### ##### ##### #####     ## ## ##### #   # ##### ####          #        #
#        #                                                                                 #        #
#        !                                                                                 !        #
#                                                                                                   #
#            ! ####################################################################### !            #
#                                                                                                   #
#                                                                                                   #
#  S                                              +                                              S  #
#                                                                                                   #
#####################################################################################################
