///////////////////////////////////////////////////
// *gold: $ there is gold here !
// *fuel: + there is fuel here !
// *start: * start positions
// *flag: & this cell have a persistent unique id
// *trap: ! something bad will happen there
// *exit: Ω this is usually the main goal,
//  with more subgoals
// *portals: ~ = % @ portals will tp you to
//  a random portal with the same symbol
///////////////////////////////////////////////////
///////////////////////////////////////////////////
// The World //////////////////////////////////////
///////////////////////////////////////////////////
╔═══╦═════════╦══════╦════════════════════════════╗
║   ║         ║      ║                            ║
║ % ║   ║     ║   ║  ║  ╔═════╗   ╔═══════════╗   ║
║   ║   ║     ║   ║  ║  ║     ║   ║     *     ║   ║
║   ║   ║     ║   ║  ║  ║  ║  ║   ║           ║   ║
║   ║   ║         ║     ║  ║  ║   ║     F     ║   ║
║   ║   ╚═════════╩═════╝  ║  ║   ║*   FFF   *║   ║
║   ║                      ║  ║   ║     F     ║   ║
║   ╠════════════════════  ║  ║   ║           ║   ║
║   ║                      ║  ║   ║     *         ║
║   ║    ╔═════════════════╝  ║   ╚═══════════╝   ║
║   ║    ║                    ║                   ║
║   ║ FF ║   ═════════════════╩═══════════════╗   ║
║   ║    ║                                  % ║   ║
║   ║    ╚══════╦═══════════╦═════════════════╣   ║
║   ║           ║ @         ║               @ ║   ║
║ F ╚═══════    ╚═════════  ║  ═══════════════╝   ║
║                           ║                     ║
╠═══════════════════════════╩══════════════════ F ║
║   $                 Ω                           ║
║ F ╔═════════════════╦═══════════════════════════╣
║   ║ F             @ ║ %                         ║
║   ║ F ══════════════╬════════════════════════ F ║
║   ║ F               ║                           ║
║   ╠═══════════════  ║  ═════════════════════╗ F ║
║   ║                 ║                       ║   ║
║   ║   ══════════════╩══════════════════╗    ║   ║
║   ║                                    ║    ║   ║
║   ╚═══════════════╗  ╔══════════════   ║ FF ║   ║
║                   ║  ║ %               ║    ║   ║
║   ╔═══════════╗   ║  ╠═════════════════╝    ║   ║
║   ║     *     ║   ║  ║                      ║   ║
║   ║           ║   ║  ║  ════════════════════╣   ║
║   ║     F     ║   ║  ║                      ║   ║
║   ║*   FFF   *║   ║  ╠════════╦════════╗    ║   ║
║   ║     F     ║   ║  ║        ║        ║    ║   ║
║   ║           ║   ║  ║    ║   ║   ║    ║    ║   ║
║   ║     *         ║       ║   ║   ║    ║    ║   ║
║   ╚═══════════╝   ╚═══════╝   ║   ║    ║    ║ @ ║
║                                   ║         ║   ║
╚═══════════════════════════════════╩═════════╩═══╝
