///////////////////////////////////////////////////
// The World
///////////////////////////////////////////////////
+++++++++++++++++++++++++++++++++++++++++++++++++++
+   +         +      +                            +
+ % +   +++   +   +  +  +++++++   +++++++++++++   +
+   +   +++   +   +  +  +     +   +     *     +   +
+   +   +++   +   +  +  +  +  +   +           +   +
+   +   +++       +     +  +  +   +     F     +   +
+   +   +++++++++++++++++  +  +   +*   FFF   *+   +
+   +                      +  +   +     F     +   +
+   +++++++++++++++++++++  +  +   +           +   +
+   +                      +  +   +     *         +
+   +    +++++++++++++++++++  +   +++++++++++++   +
+   +    +                    +                   +
+   + FF +   ++++++++++++++++++++++++++++++++++   +
+   +    +                                  @ +   +
+   +    ++++++++++++++++++++++++++++++++++++++   +
+   +           + @         +               % +   +
+ F ++++++++++  ++++++++++  +  ++++++++++++++++   +
+                           +                     +
+++++++++++++++++++++++++++++++++++++++++++++++ F +
+                                                 +
+ F +++++++++++++++++++++++++++++++++++++++++++++++
+   +  F            % + @                         +
+   + F +++++++++++++++++++++++++++++++++++++++ F +
+   +  F              +                           +
+   ++++++++++++++++  +  ++++++++++++++++++++++ F +
+   +                 +                       +   +
+   +   ++++++++++++++++++++++++++++++++++    +   +
+   +                                    +    +   +
+   +++++++++++++++++  +++++++++++++++   + FF +   +
+                   +  + %               +    +   +
+   +++++++++++++   +  +++++++++++++++++++    +   +
+   +     *     +   +  +                      +   +
+   +           +   +  +  +++++++++++++++++++++   +
+   +     F     +   +  +                      +   +
+   +*   FFF   *+   +  +++++++++++++++++++    +   +
+   +     F     +   +  +        +        +    +   +
+   +           +   +  +  +++   +   +    +    +   +
+   +     *         +     +++   +   +    +    +   +
+   +++++++++++++   +++++++++   +   +    +    + @ +
+                                   +         +   +
+++++++++++++++++++++++++++++++++++++++++++++++++++
