/////////////////////////////////////////////////////////////////////////////////////////////////
// gold	: $ the is gold here !
// fuel : + you can find fuel on this cell
// start : * this is where players arrive on the board
// flag : & this cell will have a persistent unique id
// trap : ! this is usually a cell you want to avoid
// exit : Ω this is usually the main goal, with more subgoals
// portals : ~ = % @ portals will tp you to any portal with the same symbol
/////////////////////////////////////////////////////////////////////////////////////////////////
#################################################################################################
#                                                                                               #
#       %                                  F                       Ω                    @       #
#                                                                                               #
#             #################################################################                 #
#                                                                                               #
#       *                                                             *                 $       #
#                                                                                               #
#             #   # ##### #     #     #####       #   # ##### ####  #     ####                  #
#             #   # #     #     #     #   #       #   # #   # #   # #     #   #                 #
#      &      ##### ###   #     #     #   #       # # # #   # ####  #     #   #         &       #
#             #   # #     #     #     #   #       # # # #   # #  #  #     #   #                 #
#             #   # ##### ##### ##### #####       ## ## ##### #   # ##### ####                  #
#                                                                                               #
#                                  $                                                            #
#                                                                                               #
#             #################################################################                 #
#                                                                                        %      #
#      @                                                                                        #
#                                             F                                                 #
#                                                                                               #
#################################################################################################
