###################
#        #        #
#        #        #
#        #        #
#   S             #
#        #        #
#        #        #
#        #        #
###################
