#################################################################################################
#                                          #                    #                               #
#                            ░             #                    #                               #
#       F                                  #                    #           Ω                   #
#      FFF                  ▓              #                    #                               #
#     FFFFF                   ■            #                    #                               #
#      FFF                                 #                    #                               #
#       F               ⚑      ×           #                    #            Ω                  #
#                                          #                    #                               #
#                        ■                 #                    #                               #
#                                          #                    #                               #
#                                          #                    #             Ω                 #
#                                          #                    #                               #
#                           F              #                    #                               #
#                          FFF                                  #                               #
#                         FFFFF            #                    #              Ω                #
#                          FFF             #                    #                               #
#                           F              #                    #                               #
#                                          #                    #                               #
#                                          #                    #                               #
#################################################################################################